000000w0w0
0w0w00w0w0
000w000000
ww000w0w00
0000w00w00
000000wwww
w0w0000000
0000www000
0w000000w0
0w0w0000w0